OOOOOOOOOO
O O X  O O
O  .OO   O
O O      O
O OOOO O.O
O O O    O
O OOOOOO.O
O O      O
O O OOOOOO
O  .     U
OOOOOOOOOO 